04444444444444444440
60300000000000000007
60301222210001122107
60303000030000390307
60383000032200300307
60121000030000300307
60000000030222100307
62222221030000000307
69000003012222222107
60000003000000000007
60000003002222222227
60122003000000000007
60300003022222102227
60301221000000300007
60303000022100300007
60301222000300122107
60300000000300000307
60122222222100000307
60000000000000000397
05555555555555555550
