0f0f0f0f0f0f0f0f0f0f0f0f0f0f0f0f0f0f0f0f
0f1010101010101010101010101010101010100f
0f0000001500000000000000001600150000000f
0f0010100510101010100010101000051010000f
0f0000000415100000000000001000040000000f
0f1010000400101000101010101000040010100f
0f0000000400100000000000001000040000000f
0f0000100400101610101010101000041010000f
0f1000000400000000000000000000040000000f
0f0000000400101010101010101000041510100f
0f0000000400000500000000150500040000000f
0f0010100416150400000010100400041010000f
0f0000000400000400000000000400041400000f
0f1010140600000410101010000416061010100f
0f0000000000000400000000000400000000000f
0f0016101010100400000000160410101010000f
0f0000000000000600101010100412000000000f
0f0000000000000000000000150613000000000f
0f1010101010101010101010101010101010100f
0f0f0f0f0f0f0f0f0f0f0f0f0f0f0f0f0f0f0f0f
