000e0e0e0e0e0e0e0e0e0e0e0e0e0e0e0e0e0e00
0e1404000d07070708000000090307070707080e
0e0004000415000000000016000400000000000e
0e00040004000d0707030800000a0707070c000e
0e0004000400040000040000000000120004000e
0e000a070b000a0707030707070c00130004000e
0e0000000000000000040000000400000004000e
0e0707070707070c00040000000400000004000e
0e00000000000004000a070707030707070b000e
0e0015000016000400000000000000000000000e
0e00000000000004000d0707070707070708000e
0e000d070800000400040000000000000000000e
0e00040000000004000a070707070c000907070e
0e0004000d07070b00000000000004000000000e
0e000400041400000009070c000004000000000e
0e0004000a07070c0000000400000a07070c000e
0e0004000000000400000004000000000004000e
0e000a07070707030707070b001600000004000e
0e0000000000000000000000000000000004140e
000e0e0e0e0e0e0e0e0e0e0e0e0e0e0e0e0e0e00
