0d0707070707070707070707070707070707070c
040202020f0f0f0f0f0f0202020f0f0202021404
04150f020f021602020f020f020f0202160f1504
040f0f020f020f02020f020f020f0202020f0f04
040202020f0215020202150f020f020f020f0204
040f0f020f020f0f0f0f0f0f020f020f020f0f04
04020f020f020f1502020202020f020f020f0204
040f0f0216020f0f0f0f0f0f0202020f020f0f04
04020f020f0215020f02120f0f0f160f020f0204
040f0f020f020f020f02130f150f020f020f0f04
040202020f020f020f02020f020f020f020f0204
040f0f020f020f020f02020f020f020f020f0204
04020f020f020f02020202020202020f020f0204
04150f020f0f0f0f0f0f0f0f0f0f0f0f020f1504
040f0f02020f0f0f0f0f0f0f0f0f0f02020f0204
0402020202020202020202020202020202020204
0402160f0f0f0f0f0f0f0f0f0f0f0f0f0f0f0f04
0402020202020202020202020202020202020f04
040f0f0f0f0f0f0f0f0f0f0f0f0f0f0f0f021404
0a0707070707070707070707070707070707070b
