0d0707070707070707070707070707070707070c
04020202020202140f1502020202020202021504
04020f0f0f0f020f0f0f020f0f020f020f0f0f04
04020f020f0f0f0f0f0f0f0f0f0f0f020f020f04
0402020202020202020202020202020202020204
04020f0f0f0f0f0f0f0f0f0f0f0f0f0f0f020f04
04020f020f020f020f020f150f020f020f020204
0402020202020202020202020f02020202020204
040f0f0f0f020f0f0f0f0f020f0f0f0f0f0f0f04
04020f020202020202020f020f020f020f021504
040202020f0f160f0f020f020f020f0202020204
04020f0f0f020f150f020f02020202020f0f0f04
04020f020f020f020f020f0f0f0f0f020f020f04
0402020202020f020f02020202140f0202020204
040f0f0f0f0f0f020f0f0f0f0f0f0f0f0f0f0204
04020f020f020f020f020f020f020f020f021604
0402020216020202020202020202020202020204
04120202020f0f0f0f020f0f0f0f0f0f0f0f0f04
0413020202150202020202020202020202021404
0a0707070707070707070707070707070707070b
