0d0707070707070707070707070707070707070c
040f02140f0f0202020f0f1402020202020f0f04
040202020f0f1502020f0f02020f02020f0f0204
0402020f0f0f020f020202020f02020f16020204
040202150f0f02020f02020f02020f0202020204
04020f0f0f0f0f020f0f0f0f0f0f0f0f0f0f1504
04020f02020f0f0202020212020f0f02020f0204
04020202020f0216020202130f0f0f0202020204
040202020f0f02020f02020f0f140f0f02020204
040f0f02020f0202020f0f0f02020f02020f0f04
04020f0202160202020f0f0202020f02020f0204
04020202020f02020f02020f02020f0f02020204
04020f0f020f150f020202020f020f02020f0204
04020f15020f0f020202020202020202020f0204
04020f0f0f0f0f020f0f0f0f0f0f0f0f0f0f0204
040202020f0f02020f02020f0202150f02020204
040202020202020f020202020f0202020f020204
04020f0f02160f02020f0f02020f0f02020f0204
040f0f0202020202020f0f0202150f0202021504
0a0707070707070707070707070707070707070b
