1010101010101010101010101010101010101010
100f020202020202020202020202020202020f10
100f0202020f020e0202020e0202020202020f10
100f0202150f02020e020e020202020202020f10
100f0f0f0f0f0202020e0202160f0f0f0f0f0f10
100202020202020e0e0e0e0e0202020202020210
10020f0202020e02020202020e0202020f020210
10020f16020e020e0202020e020e02020f160210
10020f160e020e0e020e020e0e020e150f160210
10020f0e02020202020e02020202020e0f020210
1002020e020f0f0f020e020f0f0f020e02020210
1002020e020f0f020e0e0e020f0f020e020f0210
1002020e02020202021602020202020e020f0210
10020f020e02020e0202020e02020e02020f0210
10020f02020e0202020e1215020e0202020f1410
10020f0202020e0e0202130e0202020f0f0f0f10
10020f0f0f0202020e0e0e020202020f02020210
100202020f0202160f0f0f160202020f02020210
100214150f020f0f0f0f0f0f0f0f020202020210
1010101010101010101010101010101010101010
