000e0e0e0e0e0e0e0e0e0e0e0e0e0e0e0e0e0e00
0e0907070707070707070708000000000000000e
0e140000000000000000150000000d070707160e
0e090707070716070716070c000004000000000e
0e0000000000000000000004000004000005000e
0e00090307070707070c0006000004000004000e
0e0000040000000000041500000004000004000e
0e05000400001600000400000d070b000004000e
0e0400040005000500040000041200000004000e
0e0400040004000400040000041300000004000e
0e04000400040004000400000a070716030b000e
0e0400040004000400040000000000000400000e
0e040004000400040004000d070708000400090e
0e0400040004000400040004000000000400000e
0e04000400060004000a0703070707070308000e
0e0600041500000400000000000000000000000e
0e0000060005000a07070707070707070c16000e
0e0000000004000000000000000000000400000e
0e000000000a070707070707070708140415140e
000e0e0e0e0e0e0e0e0e0e0e0e0e0e0e0e0e0e00
