0f0f0f0f0f0f0f0f0f0f0f0f0f0f0f0f0f0f0f0f
0f1010101010101010101010101010101010100f
0f0202020202020202020202020202051502020f
0f0210100410101010100210101010041010020f
0f0202020415020202020202020214040202020f
0f1010020410101002101010101010041010100f
0f0202020402020202020202020202040202020f
0f0210100410101602021010101010041010100f
0f0202020402020202020202020202040202020f
0f1010020402101010101010020210041610100f
0f0202020402150502020202020502040202020f
0f0210100410100402020210100410041010020f
0f0202020602020402020202020402060202140f
0f1010101002020410101010020410101010100f
0f0202020202020402020202020402020202020f
0f0216101010100402020202160410101010020f
0f0202020202020402101010100412020202020f
0f0202020202140602020202150613020202020f
0f1010101010101010101010101010101010100f
0f0f0f0f0f0f0f0f0f0f0f0f0f0f0f0f0f0f0f0f
