1010101010101010101010101010101010101010
1000000000001000000000001410000016000010
1000101010101015101010101010101510100010
1000100000001600160000100000000000100010
1000100000001000000000101010101000100010
1000100010101010101015100000001000100010
1000100010000000000000160000001000160010
1000100010001010101010101000001010101510
1000100010001000000000001010101000000010
1000171010001000001012001000001500101010
1000150010001016001013001000161000101410
1000100010001500001010001000001000100010
1000100010101010150000001000001000100010
1000100010000010101010101000001000100010
1000100010000000000000000000001000100010
1000100010101010101010101010101000150010
1000100010000000000010000000000000100010
1000101010101010101710101010101010100010
1000000000000000000000000000000000000010
1010101010101010101010101010101010101010
