1010101010101010101010101010101010101010
1000000000000000001000001000000000000010
1010151010101015101010101010151010101510
1000000000001600000000000000001000000010
1010101010151010101010151015101010151010
1000000000000000000000001000001000000010
1010171010151010171010101015101015101010
1000001000000000001000000000001000000010
1015101010101010151010151010101015101010
1014000000000000001000001000000000160010
1010151017101010101010151015101010101010
1000000000000000000000001000001012000010
1010101010101010171010101015101013000010
1000000000000000001010101000141000000010
1010151010151010151015101015101010101510
1000001000001000000000000000001000000010
1010151010101010151010101010101015101010
1000000000001000160000000000001000000010
1000001000001000001000001000000000000010
1010101010101010101010101010101010101010
