04444444444444444440
60000009300030000007
60221222122212201227
60003000300000003007
60000000000030003007
60221222122212221227
60003000300000093007
60000000300030000007
62201202122012201227
60003000300030003007
60003000300030003007
60221222102212221227
60000000300030003007
60003000000000000007
62221220122212221207
60003000300030003007
60000000300000003007
62201222122212221027
60000009300038000007
05555555555555555550
