44444444444444444444
60000000000000000007
60322222300032222307
60300000000000000307
60300000000000009307
60222222222222222207
60300000000000000307
60300009300030000007
60322222200022222327
60000000300038000007
60000000300030000007
60322222200022222307
60300000300030000307
60300000000000000307
60222222222222220207
62300000000000000307
60000000300390000307
60322222200222222307
60000000000000000007
55555555555555555555
