04444444444444444440
60000000022200000007
69122221000000122107
62100001222210000307
60000000000030000307
60012222210030000307
63030000030032210307
63030000030000930307
63030121030012230307
63030303030038000307
63030303030012221107
63030303030000003007
63030303030122203037
63030303030300003007
63030303012222222107
63030003000000000007
60012101222222210307
60000300000000030307
61000000222222012197
05555555555555555550
