44444444444444444444
62000200022900000027
60200300022002300207
60020302000020002007
60002300200200300007
60222220222222222207
60200320000002300207
60020302000029302007
60002300280200320007
62200300022000300227
62200000022000300227
60000300200200320007
60020302000020300007
60200320000000002207
60222220222222222207
60002300200200320007
60000002000020002007
60200320022002300297
62000000022000300027
55555555555555555555
