000e0e0e0e0e0e0e0e0e0e0e0e0e0e0e0e0e0e00
0e0000000000000000090708000000000000000e
0e1409070707070c0000000000000d070708000e
0e0708000000000907070707080004000004000e
0e0000000000000000000000040004000004000e
0e00000907070707070c0000060004000004000e
0e0500040000000000040000001404000004000e
0e04000400000000000400000d0706000004000e
0e0400040005000500040000041200000004000e
0e0400040004000400040000041300000004000e
0e0400040004000400040000090707070706000e
0e0400040004000400040000000000000400000e
0e0400040004000400040009070708000400090e
0e0400040004000400040004000000000400000e
0e0400040006000400060707070707070708000e
0e0600040000000400000000000000000000000e
0e0000060205000907070707070707080000000e
0e0000000004000000000000000000040000000e
0e0000000009070707070707070814040000140e
000e0e0e0e0e0e0e0e0e0e0e0e0e0e0e0e0e0e00
