000e0e0e0e0e0e0e0e0e0e0e0e0e0e0e0e0e0e00
0e0000000000000000000000000000000000000e
0e000d07070707070816000009070707070c000e
0e0004000000000000000000000000000004000e
0e0004150000000000000000000000001404000e
0e000307070707070707070707070707070b000e
0e0004000000000000000000000000000000000e
0e000415000000140516000e0e0e0e0e0e0e0e0e
0e000a07070707070300000e0e0e0e0e0e0e0e0e
0e000000000000000400000e0e1200000000000e
0e000000000000150400000e0e1300000000000e
0e000507070707070300000e0e0e07070708000e
0e00040000000000060000160e0000000004000e
0e00040000000000000000000e0000000004000e
0e0003070707070707070707070707080004000e
0e070b000000000000000000000000000004000e
0e0000000000000005000005140000000004000e
0e000907070707070b00000a07070707070b000e
0e1500000000001600000000000000000000000e
000e0e0e0e0e0e0e0e0e0e0e0e0e0e0e0e0e0e00
