0404040404040404040404040404040404040404
060f0202140f0202020f0f140202020202020f07
06020202020f0202020f0f02020f0202020f0207
0602020f020f020f020202020f0202160f020207
060202150f0f02020f02020f02020f0202020207
06020f0f0f0f0f020f0f0f0f0f0f0f0f0f0f0207
06020f02020f0f0202020212020f0f02150f0207
06020202020f020f020202130f140f0202020207
060202020f0f02020f16020f02020f0f02020207
060f0f02020f0202020f0f0202020f02020f0f07
06020f0202160202020f0f0202020f02020f0f07
06020202020f02020f02020f02020f0f02020207
0602020f020f020f020202020f020f0202020207
06020f15020f0f0202020202020202020f0f0207
06020f0f0f0f0f020f0f0f0f0f0f0f0f0f0f0207
060202020f0f02020f02020f0202140f02020207
060202020202020f020202020f0202020f020207
06020f0202160f02020f0f02020f0f02020f0907
060f020202020202020f0f0202020f0202150f07
0505050505050505050505050505050505050505
