0004040404040404040404040404040404040400
0600000000000000000000000000000000000007
0600010202020202010000000102020202010007
0600030000000000000000000000000000030007
0600030000000000000000000000000009030007
0600010202020202020202020202020202010007
0600030000000000000000000000000000030007
0600030000000009010000000100000000000007
0600010202020202010000000102020202020207
0600000000000000030000000308000000000007
0600000000000000030000000300000000000007
0600010202020202010000000102020202010007
0600030000000000010000000100000000030007
0600030000000000000000000000000000030007
0600020202020202020202020202020200020007
0602010000000000000000000000000000030007
0600000000000000010000010900000000030007
0600010202020202010000010202020202010007
0600000000000000000000000000000000000007
0005050505050505050505050505050505050500
