0004040404040404040404040404040404040400
0600000000000009030000000300000000000007
0600020201020202010202020102020001020207
0600000003000000030000000000000003000007
0600000000000000000000000300000003000007
0600020201020202010202020102020201020207
0600000003000000030000000000000903000007
0600000000000000030000000300000000000007
0602020001020002010202000102020001020207
0600000003000000030000000300000003000007
0600000003000000030000000300000003000007
0600020201020202010002020102020201020207
0600000000000000030000000300000003000007
0600000003000000000000000000000000000007
0602020201020200010202020102020201020007
0600000003000000030000000300000003000007
0600000000000000030000000000000003000007
0602020001020202010202020102020201000207
0600000000000009030000000308000000000007
0005050505050505050505050505050505050500
