000e0e0e0e0e0e0e0e0e0e0e0e0e0e0e0e0e0e00
0e1404000d070707070c0000000000000000000e
0e00040004150000000a081605000907070c000e
0e0004000400000000000000040000120004000e
0e00040004000000000d07070b0000130004000e
0e000a070b00000000040000000000000004000e
0e0000000000000000040016000000000004000e
0e0707070707070c00040000000000000004000e
0e00000000000004000a070707070707070b000e
0e0015000016000400000000000000000000000e
0e00000000000004000d0707070707070708000e
0e000d070800000400040000000000000000000e
0e00040000000004000a070707070c000907070e
0e0004000d07070b00000000000004000000000e
0e000400041400000009070c000004000000000e
0e0004000a07070c0000000400000a07070c000e
0e0004000000000400000004000000000004000e
0e000a07070707030707070b001600000004000e
0e0000000000000000000000000000000004140e
000e0e0e0e0e0e0e0e0e0e0e0e0e0e0e0e0e0e00
