1010101010101010101010101010101010101010
1002020202020202020210100202020202021410
1002020707070707070210101607070707040210
1002020202021602020210100202020202040210
1002020202020202020210100202020202040210
1002021010101010101010100210100202040210
1002021010101010101010101510100202040210
1002020202020202020202020210100202040210
1010101010101010101010101010100202040210
1010101010101010101010101010100202040210
100202020202020202020402020204150f160210
100204021602020202020402020204020f0f0210
100204020f0f0f0f0f020402021504020f020210
100204020f0f0f0f0f020407070704020f020210
100204020f0f020202020202020202020f020210
100204020f0f02020f0f0f0f0f0f0f0f0f020210
100204020f0f02020f0f0f0f0f0f0f0f0f020210
101204020f0f02020f1402020202020202020210
101315020f0f0202070707070707070707070210
1010101010101010101010101010101010101010
