000e0e0e0e0e0e0e0e0e0e0e0e0e0e0e0e0e0e00
0e00000000000000000d0708000000000000000e
0e140000160000000004150000000d070708000e
0e07070707070708000a07070c0004000000000e
0e0000000000000000000000040004000005000e
0e00000d07070707070c1600060004000004000e
0e0500040000000000041500001404000004000e
0e04000400001600000400000d070b000004000e
0e0400040005000500040000041200000004000e
0e0400040004000400040000041300000004000e
0e04000400040004000400000a070707030b000e
0e0400040004000400040000000000000400000e
0e040004000400040004000d070708000400090e
0e0400040004000400040004000000000400000e
0e04000400060004000a0703070707070308000e
0e0600041500000400000000000000000000000e
0e0000060005000a070707070707070c1600000e
0e0000000004000000000000000000040000000e
0e000000000a070707070707070814041500140e
000e0e0e0e0e0e0e0e0e0e0e0e0e0e0e0e0e0e00
