0404040404040404040404040404040404040404
0602000000020000000202090000000000000207
0600020000030000000202000002030000020007
0600000200030002000000000200000002000007
0600000002030000020000020000030000000007
0600020202020200020202020202020202020007
0600020000030200000000000002030000020007
0600000200030002000000000209030002000007
0600000002030000020800020000030200000007
0602020000030000000202000000030000020207
0602020000000000000202000000030000020207
0600000000030000020000020000030200000007
0600000200030002000000000200030000000007
0600020000030200000000000000000002020007
0600020202020200020202020202020202020007
0600000002030000020000020000030200000007
0600000000000002000000000200000002000007
0600020000030200000202000002030000020907
0602000000000000000202000000030000000207
0505050505050505050505050505050505050505
